##########
#@@@######
###@######
###@######
###@######
###@@@@###
##########
##########
##########
##########